...................#.................#................
...................#.................#................
...................#.................#................
...................&.......&.........#................
....@.......&..............#.........#........|.......
............#..............#.........&................
............#..............#..........................
............#..............#..........................
............#..............#..........................
...!.!.!.!..#...!..!..!..!.#.!.!......................
......................................................