...................#.................#................
...................#.................#................
...................#.................#................
...................#.......#.........#................
....@.......#..............#.........#........|.......
............#..............#.........#................
............#..............#..........................
............#..............#..........................
............#..............#..........................
...!.!.!.!..#...!..!..!..!.#.!.!......................
......................................................