............................#.#....................
............................#.#....................
............................#.#....................
............................#.#....######..........
............................#.#..................|.
.....@...................#....#..-.................
.........................#..........-..............
.........................#......-......#...........
.........................#........-....#...........
....!........!...........#..!..-..-....#.!.........
...................................................