...............................##.....
...............................##.....
...............................##.....
......................................
......................................
......@.........##...##...............
................##...##...............
................##...##...............
................##...##...............
................##...##...............
****************##***##***************