##############################################....
.........#.........#...........#.........#...#....
.........#.........#...........#.........#...#....
.........#.........#................-....#...#####
.........#........................................
......@.........#....#............#...............
................#....#............#..#.......#####
................#....#............#..#.......#....
................#....#............#..#.......#....
.........!......#....#............#..#.......#....
****************#****#************#**#*******#****