###############################################################################################################
.........#.........#...........#.........#...#............#.............#...#.................................#
.........#.........#...........#.........#...#............#.............#...#.........-........-.....-........#
.........#.........#.....................#...#####........#.............#...#.............................-...#
.........#................................................#.............................-..............-.......
......@.........#....#............#.......................#...............#...#...............-................
................#....#............#..#.......#####........#............########.....................-.........#
................#....#............#..#.......#.......#..........#......#.................-....................#
................#....#............#..#.......#.......#..........#......#........................-.......-.....#
.........!......#....#...!........#..#...!...#.......#..........#......#...........!...!....!...!...-.!...!...#
****************#****#************#**#*******#*******#**********#******#**************************************#