.........#.........#...........#.........#...#............#.............#...#........................................................
.........#.........#...........#.........#...#............#.............#...#.................................#.......#..............
.........#.........#...........#.........#...#............#.............#...#.........-........-.....-........#.......#..............
.........#.........#.....................#...#####........#.............#...#.............................-...#.......#.............-
.........#................................................#.............................-..............-.............................
......@.........#.....#...........#.......................#...............#...#...............-....................#...............-.
................#.....#...........#..#.......#####........#............########.....................-.........#....#.....#...........
................#.....#...........#..#.......#.......#..........#......#......#..........-....................#....#.....#.....-.....
................#.....#...........#..#.......#.......#..........#......#......#.................-.......-.....#....#.....#...........
.........!......#.....#..!........#..#...!...#.......#.....!....#......#......#....!...!....!...!...-.!...!...#....#..!..#.!...!..!..
.........................................................................................................................#...........