.........#.........#...........#.........#...#............#.............#...#........................................................
.........#.........#...........#.........#...#............#.............#...#.................................#.......#..............
.........#.........#...........#.........#...#............#.............#...#.........-........-.....-........#.......#..............
.........#.........#.....................#...#####........#.............#...#.............................-...#.......#.............-
.........#...........................#....................#.............................-..............-.............................
......@.........#.....#...........#..#....................#...................................-....................#...............-.
................#.....#...........#..#....................#..............#..#.......................-.........#....#.....#...........
................#.....#...........#..#.......#####...#..........#......########..........-....................#....#.....#.....-.....
................#.....#...........#..#.......#.......#..........#......#......#.................-.......-.....#....#.....#...........
.........!......#.....#..!........#..#...!...#.......#.....!....#......#......#....!...!....!...!...-.!...!...#....#..!..#.!...!..!..
.........................................................................................................................#...........