.........#.........#...........#.........#...#............#.............#...#........................................................
.........#.........#...........#.........#...#............#.............#...#.................................#.......#..............
.........#.........#...........&.........#...#............#.............#...#.........-........-.....-........#.......#..............
.........#.........&.....................&...#____........#.............&...&.............................-...&.......&.............-
.........&...........................&....................#.............................-..............-.............................
......@.........&.....&...........&..#....................#...................................-....................&...............-.
................#.....#...........#..#....................&..............#..#.......................-.........&....#.....&...........
................#.....#...........#..#.......#____...&..........&......#______#..........-....................#....#.....#.....-.....
................#.....#...........#..#.......#.......#..........#......#......#.................-.......-.....#....#.....#...........
.........!......#.....#..!........#..#...!...#.......#.....!....#......#......#....!...!....!...!...-.!...!...#....#..!..#.!...!..!..
.....................................................................................................................................